#=###
#...#
#.~.#
#...#
#####
