......#...~~..~~..-~##~......#.##..~#....~.....#..
.....~.~#.-.....#.##+#.#.#.....#..~~.-#.~#.-.....#
.#........##................~.#.~........~........
..............~.~#.#~#....#...-.........#..#~#....
..#.........-~.#...........-~~#.#.#...~~#~..#.#.#~
...#.~#.#..#..........#.....+~..#....~.-#..~...~..
...#..#.....#...#.#.#.~#-~...#.~..~~.....~#-##..-.
...~...~#...##+..-.+...#+.#..-#..~....#........##+
.-.~#-....~#.......~+........~.-.#.#....~....#....
....~.+....~.........#.+~~~.~........~.-..........
...#.#..-...~.~~...#...-........~..#.~#..-....#...
.~.-........+...#.....-.#-.#...~.......#.......~..
.+..#....#...++~..##...#~#....~..~+#...#..#.......
.......#...~..~#.....#~.........~.~.~..~.~..-#-.#.
........-#..~#.#.~-..~...#...#.#..#........~......
.#.#.+.#.....#...~-#...#.#..#~~#~#.-#..#..#.#...#-
............~....~-.......-~....#~...#..........~.
....+#...#.......~+...~..#.#..#.~..~.#....~...+.#.
.+.-~.#...#.....#...~...~...~.....#.......##......
..##.......#..#...#...~###..#-#.~....~~#~#..-~#...
~.#....#....#..--#-#+~+-~.+.~.-......~.#..........
#.......#..#......#.#.........~..#..~~.~.....~.#..
##.#~#...#..#...~......~.#..............##....~#..
........#.#..#.###....~.~#~.....#..~#..#....~#.#..
.-#...#..~......~##~......#...#.#.~......#.~+...+#
.~...~.#.#.#.-..##..#....##...#.~#.#.-.~~.-..~#.#.
...#......~..~......~........#........~.-....~..#.
~.-+-#.#....#.+#..#+#........~..+.#...-.~~.....-..
.#......#~.~~..-......#~..~......+..~..~....~~....
#~.#~...-...#.#+..##-#........-.#...~.....~.+..##~
...~##~...~....#.........#~.......~..##+..#...#..~
.-......#..###..#~....~.#-.#+....~.......###..#.##
...~~.....~....#~....~~.......+.#.~......#-....+..
..-.~.........#..#...#..#...~~~.#~.~.~...#.~~#....
.+....-#.~............#.......~.##-#..#..#........
..-~#..##..#...+...~..~..#.....~..#.~.#.....+#....
.~.#....#......#...........~#...~.....-#...+..-#..
.......#.~....#.#.....#.~.-...-........##.~.......
..#.#.#..###.#...........+.~~..#~~~.......~..#~.~.
-.~-....#~~~.....-...-............#..~.~......+.#.
.#..#..~........#.#.#-...#...#.~.~........#.......
.#....##.##..#.#...~.......~#......#+........#-#..
...#...#..#....~-~....-.....##~#.~...#~.+.~..#..~.
~.#~..#...#.~#......+~..#..+.~.....~..........~.~.
...~.~#..~........#....##..#.~...~...#+..~-~#.~...
...#.~~..#...#...-.~..#~#....#.#.~#.+......#.#....
....#..~..~..#.....#.........#.....-..+...#~.~..-.
.....~.......~.#+.#..~.#.#...................~...~
#....#~...~#.~.~#..~..~~#-..#.........~.#......#..
##........+.....-...#..-#..#.~-....#....#....#+##.